{
	"numTilesX":26,
	"numTilesY":19,
	"size":[32,32],
	"start":[0,32],
	"tileNames":["", "tile01", "tile02", "tile03", "tile04", "tile05", "tile06", "tile07", "tile08", "tile09", "tile10", "tile11", "tile12", "tile13", "tile14", "tile15", "tile16", "tile17", "tile18", "tile19", "tile20", "tile21", "tile22", "tile23", "tile24", "tile25", "tile26", "tile27", "tile28", "tile29"],
	"tiles": [   0,  0,  0,  0,  0,  0,  0,  0,  0,  0,  0,  0,  0,  0,  0,  0,  0,  0,  0,  0,  0,  0,  0,  0,  0,  0,  
				 0,  0,  0,  0,  0,  0,  0,  0,  0,  0,  0,  0,  0,  0,  0,  0,  0,  0,  0,  0,  0,  0,  0,  0,  0, 23,  
				 0,  0,  0,  0,  0,  0,  0,  0,  0,  0,  0,  0,  0,  0,  0,  0,  0,  0,  0,  0,  0,  0,  0,  0,  0, 23,  
				 0,  0,  0,  0,  0,  0,  0,  0,  0,  0,  0,  0,  0,  0,  0,  0,  0,  0,  0,  0,  0, 28, 28,  0,  0, 23, 
				 0,  0,  0,  0,  0,  0,  0,  0,  0,  0,  0,  0,  0,  0,  0,  0,  0,  0,  0,  0,  0, 25, 27,  0,  0, 23,  
				23,  0,  0,  0,  0,  0,  0,  0,  0,  0,  0,  0,  0,  0,  0,  0,  0,  0,  0,  0,  0,  0,  0,  0,  0, 23,  
				23,  0,  0,  0,  0,  0,  0,  0, 28, 28, 28,  0,  0, 28, 28, 28, 28,  0,  0,  0,  0,  0,  0,  0,  0, 23,  
				23,  0,  0,  0,  0,  0,  0, 29, 25, 26, 27,  0,  0, 25, 26, 26, 27,  0,  0,  0,  0,  0,  0,  0,  0, 23,
				23,  0,  0,  0,  0, 29,  0,  0,  0,  0,  0,  0,  0,  0,  0,  0,  0,  0,  0,  0,  0,  0,  0,  0,  0, 23,  
				23,  0,  0,  0,  0,  0,  0,  0,  0,  0,  0,  0,  0,  0,  0,  0,  0,  0,  0,  0,  0, 15, 16,  0,  0, 23,  
				23, 29,  0,  0,  0,  0,  0,  0,  0,  0,  0,  0,  0,  0,  0,  0,  0,  0, 15, 16, 15, 18, 17, 16, 15, 16,  
				23,  0,  0,  0,  0,  0,  0,  0,  0,  0,  0,  0,  0,  0,  0,  0,  0,  0, 18, 17, 18,  7, 12, 17, 18, 17, 
				23,  1,  1,  1,  1,  1,  0,  0,  0,  0,  0, 21, 22, 21, 22,  0,  0,  0, 19, 20, 12,  7, 12,  7, 12, 24, 
				23,  2,  2,  2,  2,  2,  0,  0,  0, 21, 22, 13, 14, 13, 14, 22, 21,  0, 19, 20, 12,  7, 12,  7, 12, 24, 
				23,  3,  5,  3,  5,  3,  0,  0,  0, 13, 14, 12,  7, 12,  7, 14, 13, 22, 19, 20, 12,  7, 12,  7, 12, 24, 
				23,  4,  6,  4,  6,  4,  0,  0,  0, 12,  7, 12,  7, 12,  7,  7, 12, 14, 19, 20, 12,  7, 12,  7, 12, 24, 
				 8,  9,  8,  9,  8,  9,  8,  9,  8,  9,  8,  9,  8,  9,  8,  9,  8,  9,  8,  9,  8,  9,  8,  9,  8,  9, 
				10, 11, 10, 11, 10, 11, 10, 11, 10, 11, 10, 11, 10, 11, 10, 11, 10, 11, 10, 11, 10, 11, 10, 11, 10, 11,
				10, 11, 10, 11, 10, 11, 10, 11, 10, 11, 10, 11, 10, 11, 10, 11, 10, 11, 10, 11, 10, 11, 10, 11, 10, 11 ]
}